31 31
###############################
# 1      #        #           #
#        #        #           #
#  ####  #  ####  #  #######  #
#  #     #     #     #  #     #
#  #     #     #     #  #     #
#  ##########  ####  #  #  ####
#     #     #     #     #  #  #
#     #     #     #     #  #  #
####  #  ####  #  #######  #  #
#        #     #     #        #
#        #     #     #        #
#  #######  #  #######  #######
#           #     #           #
#           #     #           #
###############################
#        #        #           #
#        #        #           #
#  ####  #  ####  #  #######  #
#  #     #     #     #  #     #
#  #     #     #     #  #     #
#  ##########  ####  #  #  ####
#     #     #     #     #  #  #
#     #     #     #     #  #  #
####  #  ####  #  #######  #  #
#        #     #     #        #
#        #     #     #        #
#  #######  #  #######  #######
#           #     #           #
#           #     #         2 #
###############################
